#######
# @  ^#
# ^#  #
#P#  ##
#^# @@#
##^@@E#
#######
